..#####
......##.##
.##.......#
##........#
#.......@.#
##........#
.#........#
.#.......##
.#.......#
.#.....#.
.#####.#